NO ./textures/32.xpm
SO ./textures/33.xpm
EA ./textures/29.xpm
C 68,32,32
F 155,0,0

WE ./textures/30.xpm
WE ./textures/30.xpm

  11111111
 10000000011111111
100000000000000001
111000000111111101
   1000001     101
111100000111111101
1010W1100000000001111
111111111111111111
