NO ./textures/32.xpm
SO ./textures/33.xpm
WE ./textures/30.xpm
EA ./textures/29.xpm
F 155,0,0
C 68,32,32

  11111111
 1000000001
1000000001
1010000001
1010000001
101100001
1010W111
11111
